1111111111111111111
1000000000000C00001
1010110000000110E01
1100C10000000C00001
101011C00FC00010001
1001001C0000P000001
1000001010000000101
1111111111111111111