1111111111111111111
1000000000C00C00001
1010110000000110E01
1100C10000000C00001
1010110000C00010001
1001001C1000P000001
1000001010100000101
1111111111111111111
1111111111111111111
1000000000C00C00001
1010110000000110E01
1100C10000000C00001
1010110000C00010001
1001001C10000000001
1000001010100000101
1111111111111111111
1000001010100000101
1111111111111111111
1111111111111111111
1000000000C00C00001
1010110000000110E01
1100C10000000C00001
1010110000C00010001
1001001C10000000001
1000001010100000101
1111111111111111111